# Big Game Parties
## 
### 
Following is the list of ASSU-approved Big Game parties for
tomorrow night:
Alpha Delta Phi Party — George Whitaker's home, South San
Francisco.
Alpha Kappa Lambda Overnight — Pepper Tree Inn, San Jose.
Alpha Tau Omega Open House for Alumni — 10:45-12:30.
Alpha Tau Omega Overnight — Mira Mar Hotel, Half Moon Bay.
Delta Tau Delta Overnight — La Playa Hotel, Carmel.
Delta Upsilon Overnight — Los Laureles Lodge, Carmel Valley.
El Campo and El Cuadro Overnight — International Inn, South
San Francisco.
El Capitan Overnight — Chateau Boussy, Santa Cruz.
El Toro Overnight — Riverside Hotel, Santa Cruz.
Frosh Big Game Dinner Dance — Surf Club, San Francisco.
Kappa Alpha and Sigma Nu Overnight — Sonoma Mission Inn,
Sonoma.
Kappa Sigma Overnight — Pleasanton Hotel, Pleasanton.
Los Arcos Overnight — Brookdale Lodge, Brookdale.
Off-Campus Men Big Game Party — Foothill Club, Los Altos.
Phi Delta Theta Overnight — San Carlos Hotel, Monterey.
Phi Kappa Psi Overnight — Cavern Motel, Reno.
Phi Sigma Kappa Overnight — Valley Lodge, Carmel Valley.
Sigma Alpha Kpsilon Overnight Holiday Lodge, San Fran
eisco.
Sigma Chi Overnight — Rancho Rafael, Ignacio.
Stern Hall Big Game Party — S.P. Train.
Stern Wing Five Overnight — Mission Inn, Carmel.
Theta Chi Overnight — El Rio Hotel, Antioch.
'k D.'lta Chi Party Sportsmen's Lodge, South San Fran
cisco.
Theta Xi Overnight — Carmel Valley Inn, Carmel.
